
SupremaPoker Hand #2625610200043:  Tournament #26256102, ¥83.60+¥13.20 CNY 5 Card Omaha Pot Limit - Level (50/100) - 2024/07/15 23:10:04 UTC
Table 'ClubId:14625,Table:SPMA_26256102 0' 6-max Seat #5 is the button
Seat 1: 706709 (49900 in chips)
Seat 2: 312953 (59441 in chips)
Seat 3: 308535 (49750 in chips)
Seat 4: 657898 (47800 in chips)
Seat 5: 1158025 (49800 in chips)
706709: posts small blind 50
312953: posts big blind 100
*** HOLE CARDS ***
Dealt to 657898 [Qd 7d 5h 6s 9c]
308535: folds
657898: folds
1158025: folds
706709: raises 200 to 300
312953: calls 200
*** FLOP *** [7c 5c Ac]
706709: checks
312953: checks
*** TURN *** [7c 5c Ac] [6c]
706709: bets 300
312953: folds
Uncalled bet (300) returned to 706709
706709 collected 600 from pot
*** SUMMARY ***
Total pot 600 | Rake 0
Board [7c 5c Ac 6c]
Seat 1: 706709 (small blind) collected (600)
Seat 2: 312953 (big blind) folded on the Turn
Seat 3: 308535 folded before Flop (didn't bet)
Seat 4: 657898 folded before Flop (didn't bet)
Seat 5: 1158025 (button) folded before Flop (didn't bet)
Hand ended at 2024/07/15 23:10:33

SupremaPoker Hand #2625610200044:  Tournament #26256102, ¥83.60+¥13.20 CNY 5 Card Omaha Pot Limit - Level (50/100) - 2024/07/15 23:10:39 UTC
Table 'ClubId:14625,Table:SPMA_26256102 0' 6-max Seat #1 is the button
Seat 1: 706709 (50200 in chips)
Seat 2: 312953 (59141 in chips)
Seat 3: 308535 (49750 in chips)
Seat 4: 657898 (47800 in chips)
Seat 5: 1158025 (49800 in chips)
Seat 6: 1194794 (48837 in chips)
312953: posts small blind 50
308535: posts big blind 100
*** HOLE CARDS ***
Dealt to 657898 [6c Ts 4c 2h 9s]
657898: folds
1158025: folds
1194794: folds
706709: folds
312953: calls 50
308535: raises 200 to 300
312953: calls 200
*** FLOP *** [8c 6s Th]
312953: checks
308535: checks
*** TURN *** [8c 6s Th] [9d]
312953: checks
308535: bets 600
312953: folds
Uncalled bet (600) returned to 308535
308535 collected 600 from pot
*** SUMMARY ***
Total pot 600 | Rake 0
Board [8c 6s Th 9d]
Seat 1: 706709 (button) folded before Flop (didn't bet)
Seat 2: 312953 (small blind) folded on the Turn
Seat 3: 308535 (big blind) collected (600)
Seat 4: 657898 folded before Flop (didn't bet)
Seat 5: 1158025 folded before Flop (didn't bet)
Seat 6: 1194794 folded before Flop (didn't bet)
Hand ended at 2024/07/15 23:11:43

SupremaPoker Hand #2625610200012:  Tournament #26256102, ¥83.60+¥13.20 CNY 5 Card Omaha Pot Limit - Level (100/200) - 2024/07/15 23:12:27 UTC
Table 'ClubId:14625,Table:SPMA_26256102 0' 6-max Seat #2 is the button
Seat 1: 291824 (50000 in chips)
Seat 2: 1182447 (48450 in chips)
Seat 3: 787117 (48700 in chips)
Seat 4: 657898 (47800 in chips)
Seat 5: 300279 (90052 in chips)
787117: posts small blind 100
657898: posts big blind 200
*** HOLE CARDS ***
Dealt to 657898 [Kh 3c 2d 4c Jd]
300279: raises 500 to 700
291824: folds
1182447: folds
787117: calls 600
657898: folds
*** FLOP *** [2s Jh 7d]
787117: checks
300279: checks
*** TURN *** [2s Jh 7d] [Jc]
787117: checks
300279: checks
*** RIVER *** [2s Jh 7d Jc] [3s]
787117: checks
300279: checks
*** SHOW DOWN ***
787117: mucks hand
300279: mucks hand
787117 collected 1600 from pot
*** SUMMARY ***
Total pot 1600 | Rake 0
Board [2s Jh 7d Jc 3s]
Seat 1: 291824 folded before Flop (didn't bet)
Seat 2: 1182447 (button) folded before Flop (didn't bet)
Seat 3: 787117 (small blind) showed [3d 7s As 9c 5s]
Seat 4: 657898 (big blind) folded before Flop
Seat 5: 300279 mucked
Hand ended at 2024/07/15 23:13:31

SupremaPoker Hand #2625610200013:  Tournament #26256102, ¥83.60+¥13.20 CNY 5 Card Omaha Pot Limit - Level (100/200) - 2024/07/15 23:13:41 UTC
Table 'ClubId:14625,Table:SPMA_26256102 0' 6-max Seat #3 is the button
Seat 1: 291824 (50000 in chips)
Seat 2: 1182447 (48450 in chips)
Seat 3: 787117 (49600 in chips)
Seat 4: 657898 (47600 in chips)
Seat 5: 300279 (89352 in chips)
Seat 6: 1067557 (49300 in chips)
657898: posts small blind 100
300279: posts big blind 200
*** HOLE CARDS ***
Dealt to 657898 [6d Ts Ah 8c 9s]
1067557: folds
291824: raises 500 to 700
1182447: folds
787117: folds
657898: folds
300279: folds
Uncalled bet (500) returned to 291824
291824 collected 500 from pot
*** SUMMARY ***
Total pot 500 | Rake 0
Seat 1: 291824 collected (500)
Seat 2: 1182447 folded before Flop (didn't bet)
Seat 3: 787117 (button) folded before Flop (didn't bet)
Seat 4: 657898 (small blind) folded before Flop
Seat 5: 300279 (big blind) folded before Flop
Seat 6: 1067557 folded before Flop (didn't bet)
Hand ended at 2024/07/15 23:14:33

SupremaPoker Hand #2625610200014:  Tournament #26256102, ¥83.60+¥13.20 CNY 5 Card Omaha Pot Limit - Level (100/200) - 2024/07/15 23:14:42 UTC
Table 'ClubId:14625,Table:SPMA_26256102 0' 6-max Seat #4 is the button
Seat 1: 291824 (50300 in chips)
Seat 2: 1182447 (48450 in chips)
Seat 3: 787117 (49600 in chips)
Seat 4: 657898 (47500 in chips)
Seat 5: 300279 (89152 in chips)
Seat 6: 1067557 (49300 in chips)
300279: posts small blind 100
1067557: posts big blind 200
*** HOLE CARDS ***
Dealt to 657898 [Ac 8h 2h Js 5h]
291824: raises 500 to 700
1182447: raises 500 to 1200
787117: raises 500 to 1700
657898: folds
300279: calls 1600
1067557: folds
291824: calls 1000
1182447: raises 500 to 2200
787117: raises 600 to 2800
300279: calls 1100
291824: calls 1100
1182447: raises 3400 to 6200
787117: raises 18200 to 24400
300279: folds
291824: raises 25900 to 50300 and is all-in
1182447: calls 42250 and is all-in
787117: calls 25200 and is all-in
Uncalled bet (700) returned to 291824
*** FLOP *** [Kc 2c 6c]
*** TURN *** [Kc 2c 6c] [Tc]
*** RIVER *** [Kc 2c 6c Tc] [7c]
*** SHOW DOWN ***
291824: mucks hand
787117: mucks hand
291824 collected 2300 from side pot
1182447: mucks hand
291824 collected 74175 from main pot
1182447 collected 74175 from main pot
*** SUMMARY ***
Total pot 150650 Main pot 148350. Side pot 2300. | Rake 0
Board [Kc 2c 6c Tc 7c]
Seat 1: 291824 showed [Jd 4d 8s 9s 7s]
Seat 2: 1182447 showed [9h 6h 7d 8d Kd]
Seat 3: 787117 showed [Ad 4c 5s 6s Ah]
Seat 4: 657898 (button) folded before Flop (didn't bet)
Seat 5: 300279 (small blind) folded before Flop
Seat 6: 1067557 (big blind) folded before Flop
Hand ended at 2024/07/15 23:16:28

SupremaPoker Hand #2625610200015:  Tournament #26256102, ¥83.60+¥13.20 CNY 5 Card Omaha Pot Limit - Level (100/200) - 2024/07/15 23:16:40 UTC
Table 'ClubId:14625,Table:SPMA_26256102 0' 6-max Seat #5 is the button
Seat 1: 291824 (77175 in chips)
Seat 2: 1182447 (74175 in chips)
Seat 4: 657898 (47500 in chips)
Seat 5: 300279 (86352 in chips)
Seat 6: 1067557 (49100 in chips)
1067557: posts small blind 100
291824: posts big blind 200
*** HOLE CARDS ***
Dealt to 657898 [7c Kc 5h Qc Ah]
1182447: folds
657898: raises 500 to 700
300279: raises 1400 to 2100
1067557: folds
291824: calls 1900
657898: calls 1400
*** FLOP *** [3h As 9c]
291824: checks
657898: checks
300279: checks
*** TURN *** [3h As 9c] [Kh]
291824: bets 6400
657898: calls 6400
300279: folds
*** RIVER *** [3h As 9c Kh] [Ad]
291824: checks
657898: bets 12800
291824: folds
Uncalled bet (12800) returned to 657898
657898 collected 19200 from pot
*** SUMMARY ***
Total pot 19200 | Rake 0
Board [3h As 9c Kh Ad]
Seat 1: 291824 (big blind) folded on the River
Seat 2: 1182447 folded before Flop (didn't bet)
Seat 4: 657898 collected (19200)
Seat 5: 300279 (button) folded on the Turn
Seat 6: 1067557 (small blind) folded before Flop
Hand ended at 2024/07/15 23:18:41

SupremaPoker Hand #2625610200016:  Tournament #26256102, ¥83.60+¥13.20 CNY 5 Card Omaha Pot Limit - Level (100/200) - 2024/07/15 23:18:47 UTC
Table 'ClubId:14625,Table:SPMA_26256102 0' 6-max Seat #6 is the button
Seat 1: 291824 (68675 in chips)
Seat 2: 1182447 (74175 in chips)
Seat 4: 657898 (58200 in chips)
Seat 5: 300279 (84252 in chips)
Seat 6: 1067557 (49000 in chips)
291824: posts small blind 100
1182447: posts big blind 200
*** HOLE CARDS ***
Dealt to 657898 [Td 6d 7d 2h 8h]
657898: folds
300279: raises 500 to 700
1067557: folds
291824: folds
1182447: folds
Uncalled bet (500) returned to 300279
300279 collected 500 from pot
*** SUMMARY ***
Total pot 500 | Rake 0
Seat 1: 291824 (small blind) folded before Flop
Seat 2: 1182447 (big blind) folded before Flop
Seat 4: 657898 folded before Flop (didn't bet)
Seat 5: 300279 collected (500)
Seat 6: 1067557 (button) folded before Flop (didn't bet)
Hand ended at 2024/07/15 23:19:31

SupremaPoker Hand #2625610200017:  Tournament #26256102, ¥83.60+¥13.20 CNY 5 Card Omaha Pot Limit - Level (100/200) - 2024/07/15 23:19:38 UTC
Table 'ClubId:14625,Table:SPMA_26256102 0' 6-max Seat #1 is the button
Seat 1: 291824 (68575 in chips)
Seat 2: 1182447 (73975 in chips)
Seat 4: 657898 (58200 in chips)
Seat 5: 300279 (84552 in chips)
Seat 6: 1067557 (49000 in chips)
1182447: posts small blind 100
657898: posts big blind 200
*** HOLE CARDS ***
Dealt to 657898 [5d 9h Ad 8d Ks]
300279: folds
1067557: folds
291824: folds
1182447: folds
Uncalled bet (100) returned to 657898
657898 collected 200 from pot
*** SUMMARY ***
Total pot 200 | Rake 0
Seat 1: 291824 (button) folded before Flop (didn't bet)
Seat 2: 1182447 (small blind) folded before Flop
Seat 4: 657898 (big blind) collected (200)
Seat 5: 300279 folded before Flop (didn't bet)
Seat 6: 1067557 folded before Flop (didn't bet)
Hand ended at 2024/07/15 23:19:53

SupremaPoker Hand #2625610200027:  Tournament #26256102, ¥83.60+¥13.20 CNY 5 Card Omaha Pot Limit - Level (150/300) - 2024/07/15 23:29:21 UTC
Table 'ClubId:14625,Table:SPMA_26256102 0' 6-max Seat #6 is the button
Seat 1: 291824 (56475 in chips)
Seat 2: 1182447 (73225 in chips)
Seat 3: 439623 (50000 in chips)
Seat 4: 657898 (56200 in chips)
Seat 5: 300279 (99852 in chips)
Seat 6: 1067557 (48550 in chips)
291824: posts small blind 150
1182447: posts big blind 300
*** HOLE CARDS ***
Dealt to 657898 [8c Ah 2s 6c 8s]
439623: folds
657898: folds
300279: raises 750 to 1050
1067557: folds
291824: calls 900
1182447: folds
*** FLOP *** [Kh 5c Ad]
291824: checks
300279: checks
*** TURN *** [Kh 5c Ad] [Qc]
291824: bets 2400
300279: calls 2400
*** RIVER *** [Kh 5c Ad Qc] [6h]
291824: bets 7200
300279: folds
Uncalled bet (7200) returned to 291824
291824 collected 7200 from pot
*** SUMMARY ***
Total pot 7200 | Rake 0
Board [Kh 5c Ad Qc 6h]
Seat 1: 291824 (small blind) collected (7200)
Seat 2: 1182447 (big blind) folded before Flop
Seat 3: 439623 folded before Flop (didn't bet)
Seat 4: 657898 folded before Flop (didn't bet)
Seat 5: 300279 folded on the River
Seat 6: 1067557 (button) folded before Flop (didn't bet)
Hand ended at 2024/07/15 23:30:23

SupremaPoker Hand #2625610200028:  Tournament #26256102, ¥83.60+¥13.20 CNY 5 Card Omaha Pot Limit - Level (150/300) - 2024/07/15 23:30:30 UTC
Table 'ClubId:14625,Table:SPMA_26256102 0' 6-max Seat #1 is the button
Seat 1: 291824 (60225 in chips)
Seat 2: 1182447 (72925 in chips)
Seat 3: 439623 (50000 in chips)
Seat 4: 657898 (56200 in chips)
Seat 5: 300279 (96402 in chips)
Seat 6: 1067557 (48550 in chips)
1182447: posts small blind 150
439623: posts big blind 300
*** HOLE CARDS ***
Dealt to 657898 [4s Qh 5s Js Ah]
657898: raises 750 to 1050
300279: calls 1050
1067557: folds
291824: calls 1050
1182447: calls 900
439623: folds
*** FLOP *** [6d 2d 9d]
1182447: checks
657898: checks
300279: checks
291824: checks
*** TURN *** [6d 2d 9d] [Kd]
1182447: checks
657898: checks
300279: checks
291824: checks
*** RIVER *** [6d 2d 9d Kd] [Qc]
1182447: checks
657898: checks
300279: checks
291824: checks
*** SHOW DOWN ***
1182447: mucks hand
657898: shows [4s Qh 5s Js Ah] (a pair of Queens)
300279: mucks hand
291824: mucks hand
291824 collected 4500 from pot
*** SUMMARY ***
Total pot 4500 | Rake 0
Board [6d 2d 9d Kd Qc]
Seat 1: 291824 (button) showed [Ks 5h 6h Kc Td]
Seat 2: 1182447 (small blind) showed [Jd Jh 9s Kh 2s]
Seat 3: 439623 (big blind) folded before Flop
Seat 4: 657898 showed [4s Qh 5s Js Ah] and lost with a pair of Queens
Seat 5: 300279 showed [Ac 9c 3h Th As]
Seat 6: 1067557 folded before Flop (didn't bet)
Hand ended at 2024/07/15 23:31:53

SupremaPoker Hand #2625610200029:  Tournament #26256102, ¥83.60+¥13.20 CNY 5 Card Omaha Pot Limit - Level (150/300) - 2024/07/15 23:32:03 UTC
Table 'ClubId:14625,Table:SPMA_26256102 0' 6-max Seat #2 is the button
Seat 1: 291824 (63675 in chips)
Seat 2: 1182447 (71875 in chips)
Seat 3: 439623 (49700 in chips)
Seat 4: 657898 (55150 in chips)
Seat 5: 300279 (95352 in chips)
Seat 6: 1067557 (48550 in chips)
439623: posts small blind 150
657898: posts big blind 300
*** HOLE CARDS ***
Dealt to 657898 [3s 5h 5s 6d 9d]
300279: calls 300
1067557: folds
291824: raises 1050 to 1350
1182447: folds
439623: folds
657898: folds
300279: calls 1050
*** FLOP *** [3h 8s 5c]
300279: checks
291824: bets 3150
300279: calls 3150
*** TURN *** [3h 8s 5c] [Ks]
300279: checks
291824: checks
*** RIVER *** [3h 8s 5c Ks] [9h]
300279: checks
291824: checks
*** SHOW DOWN ***
300279: mucks hand
291824: mucks hand
291824 collected 9450 from pot
*** SUMMARY ***
Total pot 9450 | Rake 0
Board [3h 8s 5c Ks 9h]
Seat 1: 291824 showed [6s Ah 4c Qc 8h]
Seat 2: 1182447 (button) folded before Flop (didn't bet)
Seat 3: 439623 (small blind) folded before Flop
Seat 4: 657898 (big blind) folded before Flop
Seat 5: 300279 showed [4h 6c 2c 2d Ad]
Seat 6: 1067557 folded before Flop (didn't bet)
Hand ended at 2024/07/15 23:34:02

SupremaPoker Hand #2625610200030:  Tournament #26256102, ¥83.60+¥13.20 CNY 5 Card Omaha Pot Limit - Level (150/300) - 2024/07/15 23:34:12 UTC
Table 'ClubId:14625,Table:SPMA_26256102 0' 6-max Seat #3 is the button
Seat 1: 291824 (68625 in chips)
Seat 2: 1182447 (71875 in chips)
Seat 3: 439623 (49550 in chips)
Seat 4: 657898 (54850 in chips)
Seat 5: 300279 (90852 in chips)
Seat 6: 1067557 (48550 in chips)
657898: posts small blind 150
300279: posts big blind 300
*** HOLE CARDS ***
Dealt to 657898 [Qc Qd 4d 7h 5h]
1067557: folds
291824: raises 750 to 1050
1182447: folds
439623: folds
657898: calls 900
300279: folds
*** FLOP *** [9s 3d 2h]
657898: bets 1600
291824: folds
Uncalled bet (1600) returned to 657898
657898 collected 2400 from pot
*** SUMMARY ***
Total pot 2400 | Rake 0
Board [9s 3d 2h]
Seat 1: 291824 folded on the Flop
Seat 2: 1182447 folded before Flop (didn't bet)
Seat 3: 439623 (button) folded before Flop (didn't bet)
Seat 4: 657898 (small blind) collected (2400)
Seat 5: 300279 (big blind) folded before Flop
Seat 6: 1067557 folded before Flop (didn't bet)
Hand ended at 2024/07/15 23:35:02

SupremaPoker Hand #2625610200031:  Tournament #26256102, ¥83.60+¥13.20 CNY 5 Card Omaha Pot Limit - Level (150/300) - 2024/07/15 23:35:09 UTC
Table 'ClubId:14625,Table:SPMA_26256102 0' 6-max Seat #4 is the button
Seat 1: 291824 (67575 in chips)
Seat 2: 1182447 (71875 in chips)
Seat 3: 439623 (49550 in chips)
Seat 4: 657898 (56200 in chips)
Seat 5: 300279 (90552 in chips)
Seat 6: 1067557 (48550 in chips)
300279: posts small blind 150
1067557: posts big blind 300
*** HOLE CARDS ***
Dealt to 657898 [4h 5d 4s Ad Qs]
291824: folds
1182447: folds
439623: folds
657898: raises 750 to 1050
300279: folds
1067557: folds
Uncalled bet (750) returned to 657898
657898 collected 750 from pot
*** SUMMARY ***
Total pot 750 | Rake 0
Seat 1: 291824 folded before Flop (didn't bet)
Seat 2: 1182447 folded before Flop (didn't bet)
Seat 3: 439623 folded before Flop (didn't bet)
Seat 4: 657898 (button) collected (750)
Seat 5: 300279 (small blind) folded before Flop
Seat 6: 1067557 (big blind) folded before Flop
Hand ended at 2024/07/15 23:36:20

SupremaPoker Hand #2625610200032:  Tournament #26256102, ¥83.60+¥13.20 CNY 5 Card Omaha Pot Limit - Level (200/400) - 2024/07/15 23:36:28 UTC
Table 'ClubId:14625,Table:SPMA_26256102 0' 6-max Seat #5 is the button
Seat 1: 291824 (67575 in chips)
Seat 2: 1182447 (71875 in chips)
Seat 3: 439623 (49550 in chips)
Seat 4: 657898 (56650 in chips)
Seat 5: 300279 (90402 in chips)
Seat 6: 1067557 (48250 in chips)
1067557: posts small blind 200
291824: posts big blind 400
*** HOLE CARDS ***
Dealt to 657898 [Kc Qc 2d 9d 4d]
1182447: folds
439623: folds
657898: folds
300279: folds
1067557: folds
Uncalled bet (200) returned to 291824
291824 collected 400 from pot
*** SUMMARY ***
Total pot 400 | Rake 0
Seat 1: 291824 (big blind) collected (400)
Seat 2: 1182447 folded before Flop (didn't bet)
Seat 3: 439623 folded before Flop (didn't bet)
Seat 4: 657898 folded before Flop (didn't bet)
Seat 5: 300279 (button) folded before Flop (didn't bet)
Seat 6: 1067557 (small blind) folded before Flop
Hand ended at 2024/07/15 23:37:14

SupremaPoker Hand #2625610200033:  Tournament #26256102, ¥83.60+¥13.20 CNY 5 Card Omaha Pot Limit - Level (200/400) - 2024/07/15 23:37:21 UTC
Table 'ClubId:14625,Table:SPMA_26256102 0' 6-max Seat #6 is the button
Seat 1: 291824 (67775 in chips)
Seat 2: 1182447 (71875 in chips)
Seat 3: 439623 (49550 in chips)
Seat 4: 657898 (56650 in chips)
Seat 5: 300279 (90402 in chips)
Seat 6: 1067557 (48050 in chips)
291824: posts small blind 200
1182447: posts big blind 400
*** HOLE CARDS ***
Dealt to 657898 [3c As 7s Ah 9h]
439623: folds
657898: raises 1000 to 1400
300279: folds
1067557: folds
291824: calls 1200
1182447: folds
*** FLOP *** [8d Qs 3h]
291824: checks
657898: bets 2133
291824: calls 2133
*** TURN *** [8d Qs 3h] [Qd]
291824: checks
657898: bets 3733
291824: folds
Uncalled bet (3733) returned to 657898
657898 collected 7466 from pot
*** SUMMARY ***
Total pot 7466 | Rake 0
Board [8d Qs 3h Qd]
Seat 1: 291824 (small blind) folded on the Turn
Seat 2: 1182447 (big blind) folded before Flop
Seat 3: 439623 folded before Flop (didn't bet)
Seat 4: 657898 collected (7466)
Seat 5: 300279 folded before Flop (didn't bet)
Seat 6: 1067557 (button) folded before Flop (didn't bet)
Hand ended at 2024/07/15 23:38:45

SupremaPoker Hand #2625610200034:  Tournament #26256102, ¥83.60+¥13.20 CNY 5 Card Omaha Pot Limit - Level (200/400) - 2024/07/15 23:38:52 UTC
Table 'ClubId:14625,Table:SPMA_26256102 0' 6-max Seat #1 is the button
Seat 1: 291824 (64242 in chips)
Seat 2: 1182447 (71475 in chips)
Seat 3: 439623 (49550 in chips)
Seat 4: 657898 (60583 in chips)
Seat 5: 300279 (90402 in chips)
Seat 6: 1067557 (48050 in chips)
1182447: posts small blind 200
439623: posts big blind 400
*** HOLE CARDS ***
Dealt to 657898 [Ac 7s 6s As Td]
657898: raises 1000 to 1400
300279: folds
1067557: folds
291824: calls 1400
1182447: folds
439623: folds
*** FLOP *** [Jc 7h 2d]
657898: bets 2266
291824: calls 2266
*** TURN *** [Jc 7h 2d] [Kc]
657898: bets 5288
291824: folds
Uncalled bet (5288) returned to 657898
657898 collected 7932 from pot
*** SUMMARY ***
Total pot 7932 | Rake 0
Board [Jc 7h 2d Kc]
Seat 1: 291824 (button) folded on the Turn
Seat 2: 1182447 (small blind) folded before Flop
Seat 3: 439623 (big blind) folded before Flop
Seat 4: 657898 collected (7932)
Seat 5: 300279 folded before Flop (didn't bet)
Seat 6: 1067557 folded before Flop (didn't bet)
Hand ended at 2024/07/15 23:39:42

SupremaPoker Hand #2625610200018:  Tournament #26256102, ¥83.60+¥13.20 CNY 5 Card Omaha Pot Limit - Level (250/500) - 2024/07/15 23:48:22 UTC
Table 'ClubId:14625,Table:SPMA_26256102 0' 6-max Seat #2 is the button
Seat 1: 1193422 (50000 in chips)
Seat 2: 344196 (9300 in chips)
Seat 3: 971689 (91000 in chips)
Seat 4: 657898 (70849 in chips)
Seat 5: 410071 (35667 in chips)
Seat 6: 558106 (147442 in chips)
971689: posts small blind 250
657898: posts big blind 500
*** HOLE CARDS ***
Dealt to 657898 [5h Qs 2s 2h 3s]
410071: raises 1250 to 1750
558106: calls 1750
1193422: folds
344196: calls 1750
971689: raises 7500 to 9250
657898: folds
410071: calls 7500
558106: calls 7500
344196: raises 50 to 9300 and is all-in
971689: calls 50
410071: calls 50
558106: calls 50
*** FLOP *** [4s 5s Ts]
971689: checks
410071: checks
558106: checks
*** TURN *** [4s 5s Ts] [Kh]
971689: bets 37700
410071: folds
558106: folds
Uncalled bet (37700) returned to 971689
*** RIVER *** [4s 5s Ts Kh] [Qh]
*** SHOW DOWN ***
971689: mucks hand
344196: mucks hand
971689 collected 37700 from pot
*** SUMMARY ***
Total pot 37700 | Rake 0
Board [4s 5s Ts Kh Qh]
Seat 1: 1193422 folded before Flop (didn't bet)
Seat 2: 344196 (button) showed [3c Kc 5d 8d 2c]
Seat 3: 971689 (small blind) showed [9h Jd 9c Js As]
Seat 4: 657898 (big blind) folded before Flop
Seat 5: 410071 folded on the Turn
Seat 6: 558106 folded on the Turn
Hand ended at 2024/07/15 23:49:52

SupremaPoker Hand #2625610200019:  Tournament #26256102, ¥83.60+¥13.20 CNY 5 Card Omaha Pot Limit - Level (250/500) - 2024/07/15 23:50:02 UTC
Table 'ClubId:14625,Table:SPMA_26256102 0' 6-max Seat #3 is the button
Seat 1: 1193422 (50000 in chips)
Seat 3: 971689 (119400 in chips)
Seat 4: 657898 (70349 in chips)
Seat 5: 410071 (26367 in chips)
Seat 6: 558106 (138142 in chips)
657898: posts small blind 250
410071: posts big blind 500
*** HOLE CARDS ***
Dealt to 657898 [Js 4d 2h Ts Qc]
558106: folds
1193422: folds
971689: raises 500 to 1000
657898: folds
410071: calls 500
*** FLOP *** [Jc Kc 7c]
410071: checks
971689: checks
*** TURN *** [Jc Kc 7c] [Jh]
410071: bets 1500
971689: folds
Uncalled bet (1500) returned to 410071
410071 collected 2250 from pot
*** SUMMARY ***
Total pot 2250 | Rake 0
Board [Jc Kc 7c Jh]
Seat 1: 1193422 folded before Flop (didn't bet)
Seat 3: 971689 (button) folded on the Turn
Seat 4: 657898 (small blind) folded before Flop
Seat 5: 410071 (big blind) collected (2250)
Seat 6: 558106 folded before Flop (didn't bet)
Hand ended at 2024/07/15 23:50:25

SupremaPoker Hand #2625610200020:  Tournament #26256102, ¥83.60+¥13.20 CNY 5 Card Omaha Pot Limit - Level (250/500) - 2024/07/15 23:50:35 UTC
Table 'ClubId:14625,Table:SPMA_26256102 0' 6-max Seat #4 is the button
Seat 1: 1193422 (50000 in chips)
Seat 3: 971689 (118400 in chips)
Seat 4: 657898 (70099 in chips)
Seat 5: 410071 (27617 in chips)
Seat 6: 558106 (138142 in chips)
410071: posts small blind 250
558106: posts big blind 500
*** HOLE CARDS ***
Dealt to 657898 [Qs 7s 3s 3c 8d]
1193422: raises 500 to 1000
971689: folds
657898: folds
410071: folds
558106: calls 500
*** FLOP *** [3d Jc Ts]
558106: checks
1193422: bets 1125
558106: calls 1125
*** TURN *** [3d Jc Ts] [Ad]
558106: checks
1193422: checks
*** RIVER *** [3d Jc Ts Ad] [4h]
558106: checks
1193422: checks
*** SHOW DOWN ***
558106: mucks hand
1193422: mucks hand
558106 collected 2250 from pot
1193422 collected 2250 from pot
*** SUMMARY ***
Total pot 4500 | Rake 0
Board [3d Jc Ts Ad 4h]
Seat 1: 1193422 showed [Tc 9s 8c 8h Ac]
Seat 3: 971689 folded before Flop (didn't bet)
Seat 4: 657898 (button) folded before Flop (didn't bet)
Seat 5: 410071 (small blind) folded before Flop
Seat 6: 558106 (big blind) showed [7h Td Qh As 2c]
Hand ended at 2024/07/15 23:51:36

SupremaPoker Hand #2625610200021:  Tournament #26256102, ¥83.60+¥13.20 CNY 5 Card Omaha Pot Limit - Level (250/500) - 2024/07/15 23:51:45 UTC
Table 'ClubId:14625,Table:SPMA_26256102 0' 6-max Seat #5 is the button
Seat 1: 1193422 (50125 in chips)
Seat 3: 971689 (118400 in chips)
Seat 4: 657898 (70099 in chips)
Seat 5: 410071 (27367 in chips)
Seat 6: 558106 (138267 in chips)
558106: posts small blind 250
1193422: posts big blind 500
*** HOLE CARDS ***
Dealt to 657898 [3c 5s 7h 8d 4c]
971689: folds
657898: folds
410071: folds
558106: raises 1000 to 1500
1193422: folds
Uncalled bet (1000) returned to 558106
558106 collected 1000 from pot
*** SUMMARY ***
Total pot 1000 | Rake 0
Seat 1: 1193422 (big blind) folded before Flop
Seat 3: 971689 folded before Flop (didn't bet)
Seat 4: 657898 folded before Flop (didn't bet)
Seat 5: 410071 (button) folded before Flop (didn't bet)
Seat 6: 558106 (small blind) collected (1000)
Hand ended at 2024/07/15 23:52:14

SupremaPoker Hand #2625610200022:  Tournament #26256102, ¥83.60+¥13.20 CNY 5 Card Omaha Pot Limit - Level (250/500) - 2024/07/15 23:52:24 UTC
Table 'ClubId:14625,Table:SPMA_26256102 0' 6-max Seat #6 is the button
Seat 1: 1193422 (49625 in chips)
Seat 3: 971689 (118400 in chips)
Seat 4: 657898 (70099 in chips)
Seat 5: 410071 (27367 in chips)
Seat 6: 558106 (138767 in chips)
1193422: posts small blind 250
971689: posts big blind 500
*** HOLE CARDS ***
Dealt to 657898 [5c Jh Jc 9c 6h]
657898: folds
410071: folds
558106: raises 1250 to 1750
1193422: calls 1500
971689: calls 1250
*** FLOP *** [Qc 8c Th]
1193422: checks
971689: checks
558106: bets 2625
1193422: calls 2625
971689: folds
*** TURN *** [Qc 8c Th] [Kh]
1193422: checks
558106: bets 7000
1193422: calls 7000
*** RIVER *** [Qc 8c Th Kh] [6d]
1193422: checks
558106: checks
*** SHOW DOWN ***
1193422: mucks hand
558106: mucks hand
1193422 collected 24500 from pot
*** SUMMARY ***
Total pot 24500 | Rake 0
Board [Qc 8c Th Kh 6d]
Seat 1: 1193422 (small blind) showed [Ks Ah Qh 4c 8s]
Seat 3: 971689 (big blind) folded on the Flop
Seat 4: 657898 folded before Flop (didn't bet)
Seat 5: 410071 folded before Flop (didn't bet)
Seat 6: 558106 (button) mucked
Hand ended at 2024/07/15 23:53:51

SupremaPoker Hand #2625610200023:  Tournament #26256102, ¥83.60+¥13.20 CNY 5 Card Omaha Pot Limit - Level (250/500) - 2024/07/15 23:54:00 UTC
Table 'ClubId:14625,Table:SPMA_26256102 0' 6-max Seat #1 is the button
Seat 1: 1193422 (62750 in chips)
Seat 3: 971689 (116650 in chips)
Seat 4: 657898 (70099 in chips)
Seat 5: 410071 (27367 in chips)
Seat 6: 558106 (127392 in chips)
971689: posts small blind 250
657898: posts big blind 500
*** HOLE CARDS ***
Dealt to 657898 [6s Jh 5h Qs 6h]
410071: folds
558106: folds
1193422: raises 1250 to 1750
971689: folds
657898: calls 1250
*** FLOP *** [Qc 9s 2d]
657898: checks
1193422: bets 1625
657898: folds
Uncalled bet (1625) returned to 1193422
1193422 collected 3750 from pot
*** SUMMARY ***
Total pot 3750 | Rake 0
Board [Qc 9s 2d]
Seat 1: 1193422 (button) collected (3750)
Seat 3: 971689 (small blind) folded before Flop
Seat 4: 657898 (big blind) folded on the Flop
Seat 5: 410071 folded before Flop (didn't bet)
Seat 6: 558106 folded before Flop (didn't bet)
Hand ended at 2024/07/15 23:54:50

SupremaPoker Hand #2625610200024:  Tournament #26256102, ¥83.60+¥13.20 CNY 5 Card Omaha Pot Limit - Level (250/500) - 2024/07/15 23:54:59 UTC
Table 'ClubId:14625,Table:SPMA_26256102 0' 6-max Seat #3 is the button
Seat 1: 1193422 (64750 in chips)
Seat 3: 971689 (116400 in chips)
Seat 4: 657898 (68349 in chips)
Seat 5: 410071 (27367 in chips)
Seat 6: 558106 (127392 in chips)
657898: posts small blind 250
410071: posts big blind 500
*** HOLE CARDS ***
Dealt to 657898 [7s 9d Jd 2d 2h]
558106: folds
1193422: raises 500 to 1000
971689: folds
657898: folds
410071: calls 500
*** FLOP *** [Ts 2c 8s]
410071: checks
1193422: checks
*** TURN *** [Ts 2c 8s] [Th]
410071: bets 1500
1193422: folds
Uncalled bet (1500) returned to 410071
410071 collected 2250 from pot
*** SUMMARY ***
Total pot 2250 | Rake 0
Board [Ts 2c 8s Th]
Seat 1: 1193422 folded on the Turn
Seat 3: 971689 (button) folded before Flop (didn't bet)
Seat 4: 657898 (small blind) folded before Flop
Seat 5: 410071 (big blind) collected (2250)
Seat 6: 558106 folded before Flop (didn't bet)
Hand ended at 2024/07/15 23:55:34
